..###################
....#.P.............#
#.#.#####.#########.#
#.#...........#.#.#.#
#.#####.#.###.#.#.#.#
#...#.#.#.#.....#...#
#.#.#.#######.#.#####
#.#...#.....#.#...#.#
#####.#####.#.#.###.#
#.#.#.#.......#...#.#
#.#.#.#######.#####.#
#...#...#...#.#.#...#
###.#.#####.#.#.###.#
#.#...#.......#.....#
#.#.#.###.#.#.###.#.#
#...#.#...#.#.....#.#
###.#######.###.###.#
#.#.#.#.#.#...#.#...#
#.#.#.#.#.#.#.#.#.#.#
#.....#.....#.#.#.#.#
###################E