P..############################
......#..#........#........#..#
####..#..#######..#..#..####..#
#..............#.....#..#..#..#
#..#############..#..####..#..#
#..#..............#...........#
#..################..#..####..#
#...........#.....#..#..#.....#
#..#..#######..####..#..#..#..#
#..####..####..#..#######..####
#.....#..............#........#
#..####..####..####..#######..#
#..#.....#........#..#..#..#..#
#..#..##########..####..#..#..#
#..#.....#.....#.....#........#
#..#..#..#..#..##########..####
#..#..#.....#..#.....#........#
#..#..####..#..####..#..#######
#.....#.....#..................
#############################.E